------------------------
-                      -
-   ----------------   -
-                      -
- - - - - - - - - - - --
-                      -
-- - - - - - - - - - - -
-                      -
-                      -
-           ------------
-                      -
-                      -
------------           -
-                      -
-*                     -
------------------------